################
###@########@###
####@######@####
###@@@@@@@@@@###
##@@#@@@@@@#@@##
#@@@@@@@@@@@@@@#
#@#@@@@@@@@@@#@#
#@#@########@#@#
####@######@####
################