################
###@########@###
####@######@####
###@@@@@@@@@@###
##@@@@@@@@@@@@##
#@@@#@@@@@@#@@@#
#@@@#@@@@@@#@@@#
#@@@@@@@@@@@@@@#
#@#@@@@@@@@@@#@#
#@#@########@#@#
#@##@######@##@#
################