################
#@@@@#@@@@#@@@@#
#@@@@#@@@@#@@@@#
#@##@#@##@#@##@#
#@##@#@##@#@##@#
#@##@#@##@#@##@#
#@##@#@##@#@@@@#
#@##@#@##@#@@@@#
#@##@#@##@#@####
#@@@@#@@@@#@####
#@@@@#@@@@#@####
################