################
####@@####@@####
####@@####@@####
####@@####@@####
####@@####@@####
####@@####@@####
#@@#@@####@@#@@#
#@@#@@####@@#@@#
#@@##########@@#
#@@@@@@@@@@@@@@#
#@@@@@@@@@@@@@@#
################