################
#@@@@@@@@@@@@@@#
##@@########@@##
###@@######@@###
####@@####@@####
#####@@##@@#####
#####@@##@@#####
####@@####@@####
###@@######@@###
##@@########@@##
#@@@@@@@@@@@@@@#
################
