################
######@##@######
###@##@@@@##@###
##@@@@@@@@@@@@##
#@@@@@@@@@@@@@@#
@@@@@@@@@@@@@@@@
@@@@@@@@@@@@@@@@
@@@@@@@@@@@@@@@@
#@@@@@@@@@@@@@@#
##@@@#@@@@#@@@##
###@###@@###@###
#######@@#######